[
	{
		"type" : "mapgen",
		"om_terrain" : ["shooting_range"],
		"method": "json",
		"weight": 250,
		"object": {
			"fill_ter": "t_floor",
			"rows": [
            ".______________________.",
            ".______________________.",
            ".|--------------------|.",
            ".|xxxxxxxxxxxxxxxxxxxx|.",
            ".|xxxxxxxxxxxxxxxxxxxx|.",
            ".|xxxxxxxxxxxxxxxxxxxx|.",
            ".|xxxxxxxxxxxxxxxxxxxx|.",
            ".|xxxxxxxxxxxxxxxxxxxx|.",
            ".|xxxxxxxxxxxxxxxxxxxx|.",
            ".|xxxxxxxxxxxxxxxxxxxx|.",
            ".|xxxxxxxxxxxxxxxxxxxx|.",
            ".|xxxxxxxxxxxxxxxxxxxx|.",
            ".|xxxxxxxxxxxxxxxxxxxx|.",
            ".|xxxxxxxxxxxxxxxxxxxx|.",
            ".|xxxxxxxxxxxxxxxxxxxx|.",
            ".|xxxxxxxxxxxxxxxxxxxx|.",
            ".|xxxxxxxxxxxxxxxxxxxx|.",
            ".|xxxxxxxxxxxxxxxxxxxx|.",
            ".|xxxxxxxxxxxxxxxxxxxx|.",
            ".|xxxxxxxxxxxxxxxxxxxx|.",
            ".|xxxxxxxxxxxxxxxxxxxx|.",
            ".|xxxxxxxxxxxxxxxxxxxx|.",
            ".|xxxxxxxxxxxxxxxxxxxx|.",
            ".|xxxxxxxxxxxxxxxxxxxx|."
            ],
			"terrain": {
				"|": "t_wall_v",
				"-": "t_wall_h"
			},
			"furniture": {
				"z": "f_crate_c"
			}
		}
    },	{
		"type" : "mapgen",
		"om_terrain" : ["shooting_range_entrance"],
		"method": "json",
		"weight": 250,
		"object": {
			"fill_ter": "t_floor",
			"rows": [
            ".|xxxxxxxxxxxxxxxxxxxx|.",
            ".|xxxxxxxxxxxxxxxxxxxx|.",
            ".|xxxxxxxxxxxxxxxxxxxx|.",
            ".|xxxxxxxxxxxxxxxxxxxx|.",
            ".|xxxxxxxxxxxxxxxxxxxx|.",
            ".|                    |.",
            ".|                    |.",
            ".|       ######       |.",
            ".|-------#@@@@#-------|.",
            ".|        @@@@        |.",
            ".|                    |.",
            ".|                    |.",
            ".|                    |.",
            ".|                    |.",
            ".|-*-*----------------|.",
            ".|     |              |.",
            ".|     |              |.",
            ".|--   *              |.",
            ".|A    |              |.",
            ".|--------------+-----|.",
            ".______________________.",
            ".______________________.",
            ".______________________.",
            ".______________________."
            ],
       			"terrain": {
				"|": "t_wall_v",
				"-": "t_wall_h"
			},

			"furniture": {
				"@": "f_bed"
			}
		}
    }
]
