[
	{
		"type" : "mapgen",
		"om_terrain" : ["shooting_range_1"],
		"method": "json",
		"weight": 250,
		"object": {
			"fill_ter": "t_floor",
			"rows": [
            ".|                    |.",
            ".|                    |.",
            ".|                    |.",
            ".|                    |.",
            ".|                    |.",
            ".|                    |.",
            ".|                    |.",
            ".|                    |.",
            ".|                    |.",
            ".|                    |.",
            ".|                    |.",
            ".|                    |.",
            ".|                    |.",
            ".|                ##  |.",
            ".|                #  T|.",
            ".|                #  T|.",
            ".|                #  T|.",
            ".|                #  T|.",
            ".|                #  T|.",
            ".|-----+--------+-----|.",
            ".______________________.",
            ".______________________.",
            ".______________________.",
            ".______________________."
            ],
			"terrain": {
				"|": "t_wall_v",
				"-": "t_wall_h"
			},
			"furniture": {
				"z": "f_crate_c"
			}
		}
    },	{
		"type" : "mapgen",
		"om_terrain" : ["shooting_range_2"],
		"method": "json",
		"weight": 250,
		"object": {
			"fill_ter": "t_floor",
			"rows": [
            ".______________________.",
            ".______________________.",
            ".|--------------------|.",
            ".|                    |.",
            ".|                    |.",
            ".|                    |.",
            ".|                    |.",
            ".|                    |.",
            ".|                    |.",
            ".|                    |.",
            ".|                    |.",
            ".|                    |.",
            ".|                    |.",
            ".|                    |.",
            ".|                    |.",
            ".|                    |.",
            ".|                    |.",
            ".|                    |.",
            ".|                    |.",
            ".|                    |.",
            ".|                    |.",
            ".|                    |.",
            ".|                    |.",
            ".|                    |."
            ],
       			"terrain": {
				"|": "t_wall_v",
				"-": "t_wall_h"
			},

			"furniture": {
				"@": "f_bed",
				"b": "f_bench",
				"c": "f_counter",
				"d": "f_dresser",
				"h": "f_chair",
				"K": "f_wood_keg",
				"L": "f_locker",
				"n": "f_table",
				"o": "f_bookcase",
				"r": "f_rack",
				"S": "f_sink",
				"T": "f_toilet",
				"W": "f_canvas_wall",
				"w": "f_groundsheet",
				"z": "f_crate_c"
			}
		}
    }
]
